#######################################
#                                     #
#                                     #
#                      P              #
#                                     #
#                                     #
#                                     #
#                                     #
#        #####################        #
#                                     #
#                                     #
#                                     #
#                                     #
#                                     #
#                                     #
#                                     #
#        #####################        #
#                                     #
#                                     #
#                                     #
#                                     #
#                                     #
#                                     #
#                                     #
#                                     #
#                                     #
#                                     #
#                                     #
#######################################