##############################
#                            #
############################ #
#                            #
# ############################
#                            #
############################ #
#o                           #
##############################