#############################################################################
#o                                                                          #
# # ######### ############# ########### ####### ######### ######### ##### # #
# #       ###    m ####         ###         ###       ###       ### ##### # #
# # ######### ####  ####### ########### ####### ######### ######### ##### # #
# # ######### ##### ####### ########### ####### ######### ######### ##### # #
# # ######### ###   ####### ########### ####### ######### ######### ##### # #
# #       ###     ######### ########### #######       ### #########       # #
# # ######### ############# ########### ####### ######### ######### ##### # #
# # ######### ############# ########### ####### ######### ######### ##### # #
# # ######### ############# ########### ####### ######### ######### ##### # #
# #       ### #########         ####### #######       ###       ### ##### # #
# # ######### ############# ################### ######### ######### ##### # #
#                m                                                          #
#############################################################################